111111111111111111111111111111
100100010000000000000000000041
101101010000000000000000000101
100000001001111100000000000001
101111071031000000000000000001
101001091001010100000000000001
101001111100010100000000000001
101000000000010100000000000001
100010000100010100000000000001
100000000000000000000000000001
100000000000000000000000000001
100000000000000000000000000001
100000000000000000000000000001
100000000000000000000000000001
100000000000000000000000000001
100000000000000000000000000001
100000000000000000000000000001
100000000000000000000000000001
100000000000000000000000000001
100000000000000000000000000001
100000000000000000000000000001
100000000000000000000000000001
100000000000000000000000000001
100000000000000000000000000001
100000000000000000000000000001
100000000000000000000000000001
100000000000000000000000000001
100000000000000000000000000001
1000000000000000000000000000;1
111111111111111111111111111111