111111111111111111111111111111
100001010000000000000000000001
101101011110010000000000000081
100130000411011000000000000071
101101110111001000000000000001
100101000000000000000000000001
100101110100010000000000000001
100111000410010000000000000001
131010000410013000000000000001
101101110111010000000000000001
101000000002300000000000000001
100000000000000000000000000001
100000000000000000000000000001
100000000000000000000000000001
100000000000000000000000000001
100000000000000000000000000001
100000000000000000000000000001
100000000000000000000000000001
100000000000000000000000000001
100000000000000000000000000001
100000000000000000000000000001
100000000000000000000000000001
100000000000000000000000000001
100000000000000000000000000001
100000000000000000000000000001
100000000000000000000000000001
100000000000000000000000000001
100000000000000000000000000001
1000000000000000000000000000:1
111111111111111111111111111111